{
  "0": "97",
  "1": "98",
  "2": "99",
  "3": "100",
  "4": "101",
  "5": "102",
  "6": "103",
  "7": "104",
  "8": "105",
  "9": "106",
  "10": "107",
  "11": "108",
  "12": "109",
  "13": "110",
  "14": "111",
  "15": "112",
  "16": "113",
  "17": "114",
  "18": "115",
  "19": "116",
  "20": "117",
  "21": "118",
  "22": "119",
  "23": "120",
  "24": "121",
  "25": "122",
  "26": "48",
  "27": "49",
  "28": "50",
  "29": "51",
  "30": "52",
  "31": "53",
  "32": "54",
  "33": "55",
  "34": "56",
  "35": "57",
  "36": "32",
  "37": "33",
  "38": "34",
  "39": "35",
  "40": "36", 
  "41": "38",
  "42": "40",
  "43": "41",
  "44": "37",
  "45": "39",
  "46": "42",
  "47": "43",
  "48": "44",
  "49": "45",
  "50": "46",
  "51": "47",
  "52": "58",
  "53": "59",
  "54": "60",
  "55": "61",
  "56": "62",
  "57": "63",
  "58": "64",
  "59": "65",
  "60": "66",
  "61": "67",
  "62": "68",
  "63": "69",
  "64": "70",
  "65": "71",
  "66": "72",
  "67": "73",
  "68": "74",
  "69": "75",
  "70": "76",
  "71": "77",
  "72": "78",
  "73": "79",
  "74": "80",
  "75": "81",
  "76": "82",
  "77": "83",
  "78": "84",
  "79": "85",
  "80": "86",
  "81": "87",
  "82": "88",
  "83": "89",
  "84": "90",
  "85": "91",
  "86": "92",
  "87": "93",
  "88": "94",
  "89": "95",
  "90": "96",
  "91": "123",
  "92": "124",
  "93": "125",
  "94": "126"
}
